1111111111111111111111111
1                       1
1                       1
1                       1
1                   b   1
1                       1
1                       1
1                       1
1         b             1
1111111111111111111111111
