11111111111   11111111111
1                       1
1                       1
1                        
                         
                         
                        1
1                       1
1                       1
111111111111   1111111111
